prefer to A(동사) (rather than B(동사)) : (B 하기보다) A 하기를 더 좋아한다.
crawl : 기다
creep : 살금살금 움직이다, 기다
be covered with : ~ 로 덮여 있다.
be responsible for : ~에 책임이 있다, 책임지고 있다, ~의 원인이 되다
be worried about : ~에 대해 걱정하다
at the end of : ~ 의 끝에
willing : 기꺼이 하는[자발적인]
glide : 미끄러지듯 움직이다, 활공하다
skid : (차가) 미끄러지다
on your[the] way (to 명사) : (~로 가는) 도중에
specific : 특정한, 구체적인
in short : 간단히 말하면[요컨대]
for yourself : 혼자 힘으로[스스로], 자신을 위해
or so : (수량 뒤에서) ~ 쯤[정도]
stumble : 비틀거리다, 말을 더듬다
plunge : 추락하다, 급락하다, 뛰어들다
get back : 돌아오다[가다], 돌려받다[되찾다]
arrive at[in] : ~ 에 도착하다
possibility : 가능성
figure out : ~로 드러나다, 밝혀지다, 생산하다, (전등/수도 등을) 끄다[잠그다]
be about to : 막 ~ 하려고 한다.
rotate : 돌(리)다, 회전하다, 교대로 하다
revolve : 돌[리다], 회전하다
make a [your] decision : 결정[결심]하다
make[give, deliver] a speech
cause A to B : A 가 B하게 하다 
compare A with [to] B [명사] : A를 B와 비교하다
swirl : 빙빙 돌(리)다[소용돌이 치다]
be concerned about : ~ 에 대해 염려[걱정]하다
whirl : 빙빙[휙휙] 돌(리)다
frown : 눈산을 찌푸리다, 찌푸림
be expected to 동사 : ~라고 예상[기대]되다
be willing to 동사 : 기꺼이 ~ 하다
a variety of 다양한
as[so] far as : ~ 하는 한, ~ 까지
in a hurry : 서둘러[급히]
a glass of : ~ 한 컵, ~ 한 잔
a little : 약간의 , 조금은 있는
all day[long] : 하루 종일
