untraceable : 추적할 수 없는, 찾아낼 수 없는
come from : ~의 출신이다, ~ 에서 생기다
applicable : 해당되는, 적용되는
paricular : 특정한, 특별한, 까다로운
aunt : 고모, 이모
listen to : ~ 에 귀를 기울이다, 경청하다
talk about : ~ 에 관해 말하다
think about[of] : ~ 에 대해 생각하다, 숙고하다
have to : ~ 해야 한다.
anxiety : 불안, 염려, 걱정거리, 열망
depression : 우울증, 우울함, 불경기, 불황
seem to  : ~ 인 것 같다.
try ~ing/to : (시험삼아) ~해 보다[시도하다]/~하려고 노력하다
used to : (과거에) ~ 하곤 했다, (과거에) ~ 이었다
be going to : ~ 할 예정이다, ~ 할 것 같다
compassion : 연민, 동정심
dormitory : 공동침실, 기숙사
adoption : 입양, 채택, 선정
ba able to : ~ 할수 있다
be different from : ~ 와 다르다
be full of : ~ 으로 가득 차다
a lot of[lots of] : 많은 (=many, much)
in front of : ~ 의 앞에
adoption : 입양, 채택, 선정
orchestrate :조직하다, 오케스트라용으로 편곡하다.
A such as B [such A as B] : B 와 같은 A
for example[instance] : 예를 들면
for a long time : 오랫동안
each other : 서로
tenacity : 고집, 끈기, 강인함, 완강, 불굴, 점착력
bistro : 작은 식당
savory : 맛좋은, 기분좋은, 즐거운
in order to 동사 [so as to 동사] : ~ 하기 위하여
depend on[upon] : ~에 달려 있다.
look for : 찾다
look like : ~ 처럼 보이다, ~ 할[인] 것 같다
worry about : ~ 에 대해 걱정하다
approval request : 품의서, 신청서
detention : 구금[구류], 방과 후 남게 하기
worry about : ~ 에 대해 걱정하다
find out :  알아내다[찾아내다]
government : 정부, 정치
go on : 계속하다[게속되다], (일이) 일어나다
concern : 우려[걱정], 관심(사), 관련되다, 걱정시키다
underlying : 근본적인, 근원적인, 밑에 있는
abruptly : 갑자기, 불쑥, 뜻밖에, 퉁명스럽게, 무뚝뚝하게
keep [on] 동사 ~ing : 계속[줄곧] ~ 하다
subject : 주제, 과목, 실험 대상, 영향받기 쉬운, 복속시키다
adoption : 입양, 채택, 선정
be interested in ~ 에 관심[흥미]이 있다.
be late for : ~ 에 늦다 [지각하다]
underlying : 근본적인, 근원적인, 밑에 있는
optimistic : 낙관적인, 낙관하는
be likely to 동사 ~ 할것 같다
according to 명사 ~ ~ 에 의하면, ~에 따라서
pessimistic : 비관적인, 비관주의적인
according to 명사 : ~에 의하면, ~에 따라서
allow : 허락하다, 허용하다
inject : 주입하다, 주사하다
embed : 박다, 끼워 넣다
instead of : 대신에
reduce : 줄이다, 축소하다
as a result : 결과적으로
in fact : 사실상, 실제로
individual : 개인[개개]의 , 개인
enclose : 동봉하다, 둘러싸다
cram : 밀어 넣다, 쑤셔 넣다, 벼락공부하다
get to 명사/동사 : ~ 에 도착하다[이르다], ~하게 되다
various : 다양한
go out : 외출하다, 밖에 나가다. 사귀다, 데이트 하다, (불이) 꺼지다
wake up : 깨어나다, 깨우다
population : 인구
deserve : ~ 을 받을 만하다, 누릴 자격이 있다
choke : 숨이 막히다, 질식하다, 질식시키다
spend + 시간[돈] + 동사 ~ing : ~ 하는데 시간을 보내다[돈을 쓰다]
purpose : 목적, 의도
