introvert : 내성시키다, 내향적인 사람, 내성적인
fundamental : 기본적인, 근원의, 기본, 근본, 기초 
regression : 복귀, 퇴보, 퇴화, 회귀
extrovert : 외향적인 사람, 외향성
aversion : 싫음, 반감, 혐오, 싫은 것
recipient : 받는 사람, 수령[수취]인
leverage : 영향력, 지렛대 사용, 차입 자본 이용, 수단, 권력
dividend : 배당금, 상금
persuasive : 설득력 있는
disorganized : 조직이 문란한, 엉터리의, 부주의한
resurrect : 부활시키나, 소생시키다
leakage : 누출, 누설
betrayal : 배반, 배신, 밀고, 내통
cognitive : 인식의, 인식력 있는
scatter : 흩뿌리다, 뿌리다, 낭비하다
dividends : 배당금
referal : 추천된 사람, refer 하기. (사람을 전문적인 도움을 받을 곳으로) 보내기[소개/위탁]
contraband : 밀매매풀, 밀수품, 불법 거래, 밀수
condemn : 규탄[비난]하다. 선고를 내리다.
depression : 우울증, 우을함, 암울함, 불경기
retrieval :검색, 되찾아 옴, 회수
impart : 전하다, 주다
ephemeral : 수명이 짧은, 단명하는, 순식간의, 덧없는
duration : 지속, 지속되는 시간
adjective : 형용사
respiration : 호흡, 호흡 작용
breed :낳다, 사육하다, 개량하다, 교배시키다
accuracy : 정확, 정확도
annoying : 짜증스러운
judge : 판사, 심판, 심사위원, 감정가, 감식가
retrieval : 검색, 회수, 되찾아 옴
seize : 체포하다, 붙잡다, 장악하다, 정렴하다
criticize : 비판하다, 비평하다
feather : 털, 깃털
proportion : 균형, 부분, 비율
subsequently : 그후에, 그 다음에, 이어서, 그결과로
collocate : 나란히 놓다, 배열하다, 배치하다
emphasize : 강좌하다, 힘주어 말하다, 역설하다
surge : 밀려들다, 급등하다
