heap : 쌓아 올리다
relax : 쉬다, 안심하다, 긴장을 풀다
take A to B : A를 B로 가져가다[데려가다]
affect : 영향을 미치다, (정서적) 충격을 주다
be based on : ~에 기초[근거]하다.
dangle : 매달(리)다
ingredient :재료[성분], 구성 요소
be supposed to 동사 ~ 하기로 되어 있다, ~ 라고 여겨지다
prevent : 막다, 예방하다
dip : 살짝 담그다, 내려가다
thousands of 수천의
eventually : 마침내, 결국
soak : 담그다, 빨아들이다
scoop : 뜨다, 퍼내다, 특종을 보도하다
at (the) least : 적어도
by the way : 그런데
in addition : 게다가 (=besides, moreover, furthermore)
reality : 현실, 진짜의, 현실의
freak : 광적으로 관심이 많은 사람, 괴짜, 괴물, 기형아
splash : (물을) 튀(기)다, 끼얹다, 첨벙거리다
sprinkle : (물, 가루를) 뿌리다
belong to : ~의 것[소유]이다, ~에 속하다
benefit : 이익[혜택], 이익을 주다[얻다]
work for : ~을 위해 일하다, ~에 근무하다
treat : 치료하다, 대우하다, 다루다, 대접하다
consignment : 탁송, 배송, 탁송물, 배송물
sow : (씨를) 뿌리다
scatter : (흩)뿌리다, 흩어지다
put on : (옷 등을) 입다, (연극 등을) 공연하다
achieve : 이루다, 성취하다(달성하다)
make sure : 확실히 ~ 하다, 확인하다
disperse : 흩어지다, 해산하다
dispatch : 발송하다, 파견하다
transport : 운송하다, 수송하다
transmit : 전송하다, 방송하다
suffer : (고통을) 겪다[경험하다]
thank A for B : A에게 B에 대해 감사하다
male/female : 남성/여성
be good at : ~ 에 능숙하다, 잘하다
tiny : 아주 작은
transplant : 이식하다, 옮겨 심다
shift : 옮기다, 바꾸다, 바뀌다, 변화, 교대 근무
after all : 결국, 어쨌든
similar : 비슷한, 유사한
at once : 즉시, 곧, 동시에, 한꺼번에
expert : 전문가
on the other hand : 한편[반면에]
